mha:                             Marianne Hansen (Privat) <marianne@hegelund-hansen.dk>
she:                             Steen Hegelund (Privat) <steen@hegelund-hansen.dk>
alunn:                           Andrew Lunn <andrew@lunn.ch>
arndb:                           Arnd Bergmann <arnd@arndb.de>
atenart:                         Antoine Tenart <atenart@kernel.org>
bjarni:                          Bjarni Jonasson <Bjarni.Jonasson@microchip.com>
bryan:                           Bryan Whitehead <Bryan.Whitehead@microchip.com>
christian.helveg:                Christian Helveg <Christian.Helveg@microchip.com>
devicetree:                      Device Tree List <devicetree@vger.kernel.org>
dmiller:                         "David S. Miller" <davem@davemloft.net>
gregory.clement:                 Gregory <gregory.clement@bootlin.com>
hkallweit:                       Heiner Kallweit <hkallweit1@gmail.com>
ioannis:                         Ioannis Kotleas <Ioannis.Kotleas@microchip.com>
jakub:                           Jakub Kicinski <kuba@kernel.org>
joergena:                        Joergen Andreasen <Joergen.Andreasen@microchip.com>
john.haechten:                   John Haechten <John.Haechten@microchip.com>
kishonv:                         Kishon Vijay Abraham I <kishon@ti.com>
lars.ellegaard:                  Lars Ellegaard <Lars.Ellegaard@microchip.com>
linux-arm:                       Linux ARM List <linux-arm-kernel@lists.infradead.org>
kernel:                          Linux Kernel List <linux-kernel@vger.kernel.org>
martin.bak:                      Martin Bak <Martin.Bak@microchip.com>
microchip:                       Microchip UNG Driver List <UNGLinuxDriver@microchip.com>
microsemi:                       Bootlin Microsemi List <microsemi@lists.bootlin.com>
miquel:                          Miquel Raynal <miquel.raynal@bootlin.com>
morten.terstrup:                 Morten Terstrup <Morten.Terstrup@microchip.com>
netdev:                          Netdev List <netdev@vger.kernel.org>
nicolasf:                        Nicolas Ferre <nicolas.ferre@microchip.com>
palle:                           Palle Christensen <Palle.Christensen@microchip.com>
rene:                            Rene Nielsen <Rene.Nielsen@microchip.com>
rking:                           Russell King <linux@armlinux.org.uk>
thomasaa:                        Thomas <Thomas.Aakjer@microchip.com>
torkil:                          Torkil Oelgaard <Torkil.Oelgaard@microchip.com>
vinodk:                          Vinod Koul <vkoul@kernel.org>
vlad:                            Vladimir Lyalikov <Vlad.Lyalikov@microchip.com>
younes:                          Younes Leroul <Younes.Leroul@microchip.com>

Frank Rowand:                    Frank Rowand <frowand.list@gmail.com
Clément Léger:                   Clément Léger <clement.leger@bootlin.com
Lizhi Hou:                       Lizhi Hou <lizhi.hou@amd.com>
Rob Herring:                     Rob Herring <robh@kernel.org>

Johan:                           Johan Furunäs Åkesson <Johan.FurunasAkesson@westermo.com>
Casper Andersson:                Casper Andersson <casper.casan@gmail.com

Ravi Hegde - C21689:             Ravi Hegde <Ravi.Hegde@microchip.com
Horatiu Vultur - M31836:         Horatiu Vultur <Horatiu.Vultur@microchip.com
Allan Nielsen - M31684:          Allan Nielsen <Allan.Nielsen@microchip.com>
Woojung Huh - C21699:            Woojung Huh <Woojung.Huh@microchip.com>
Ron Huff - C34060:               Ron Huff <Ron.Huff@microchip.com>
Steen Hegelund - M31857:         Steen Hegelund <Steen.Hegelund@microchip.com>

Anders Nielsen - M72620:         Anders Nielsen <Anders.Nielsen@microchip.com>
Bjarni Jonasson - M31672:        Bjarni Jonasson <Bjarni.Jonasson@microchip.com>
Henrik Bjoernlund - M31679:      Henrik Bjoernlund <Henrik.Bjoernlund@microchip.com>
Claus Jensen - M31673:           Claus Jensen <Claus.Jensen@microchip.com>
Joergen Andreasen - M31676:      Joergen Andreasen <Joergen.Andreasen@microchip.com>
Daniel Machon - M70577:          Daniel Machon <Daniel.Machon@microchip.com>
Lars Povlsen - M31675:           Lars Povlsen <Lars.Povlsen@microchip.com>

Dan Carpenter:                   Dan Carpenter <error27@gmail.com>
kernel-janitors@vger.kernel.org: <kernel-janitors@vger.kernel.org>

Alexandre Belloni:               Alexandre Belloni <alexandre.belloni@bootlin.com>
thomas.petazzoni@bootlin.com:    thomas.petazzoni@bootlin.com
Thomas Petazzoni:                Thomas Petazzoni <thomas.petazzoni@bootlin.com>

Torben Falkenberg - M31685:      Torben Falkenberg <Torben.Falkenberg@microchip.com
Lars Ellegaard - M31680:         Lars Ellegaard <Lars.Ellegaard@microchip.com
Kenneth Petersen - M31666:       Kenneth Petersen <Kenneth.Petersen@microchip.com

Parthiban Veerasooran - I17164:  Parthiban Veerasooran - I17164 <Parthiban.Veerasooran@microchip.com
